111111111111111111111
10000000000E0P0000001
10000000001C000000001
111111111111111111111
